19
17
###################
#........#........#
#O##.###.#.###.##O#
#.................#
#.##.#.#####.#.##.#
#....#...#...#....#
####.### # ###.####
####.#  FFF  #.####
    .  ##F##  .    
####.#       #.####
####.### # ###.####
#....#...#...#....#
#.##.#.#####.#.##.#
#O.#.....P.....#.O#
##.#.###.#.###.#.##
##.......#.......##
###################